32 32
16 30
16 0
9 9 9 9 9 9 9 9 9 9 9 9 9 9 9 2 9 9 9 9 9 9 9 9 9 9 9 9 9 9 9 9
9 0 0 0 0 0 0 0 0 0 0 0 0 7 0 0 0 0 0 0 0 0 0 0 0 0 0 0 0 0 0 9
9 0 0 9 0 0 0 0 0 0 0 0 0 9 0 9 9 7 0 0 0 0 0 0 0 7 0 0 0 0 0 9
9 0 9 9 9 9 9 0 0 0 9 9 9 9 0 0 9 9 9 9 0 0 0 9 9 9 9 9 9 0 0 9
9 0 9 0 0 0 0 0 0 0 8 0 0 9 0 0 0 8 0 9 9 0 0 9 0 0 0 0 0 0 8 9
9 0 9 0 0 0 0 0 9 0 0 0 0 9 0 0 0 0 0 0 0 0 0 0 0 0 0 0 0 0 0 9
9 0 9 9 9 0 0 9 9 9 9 0 0 0 0 0 0 0 0 0 0 0 9 0 0 0 8 7 9 0 0 9
9 0 0 9 0 0 0 0 9 0 0 0 9 9 9 9 9 9 9 9 0 0 9 9 9 9 9 9 9 0 0 9
9 0 0 0 8 0 9 9 9 0 0 0 0 8 0 0 0 0 0 9 0 0 0 9 0 0 0 0 0 0 0 9
9 0 0 0 0 0 0 0 0 0 0 0 0 0 0 0 0 9 9 9 0 0 0 9 0 0 0 0 0 0 0 9
9 0 0 9 0 0 0 0 0 7 0 9 0 0 0 0 0 9 0 0 0 0 9 9 9 9 0 0 9 0 0 9
9 0 0 9 0 9 0 0 0 0 0 9 0 0 9 9 9 9 0 0 0 0 0 0 0 0 0 0 9 0 0 9
9 0 0 9 9 9 0 0 0 0 0 9 0 0 0 0 0 0 0 0 0 0 0 0 0 9 0 0 9 0 0 9 
9 0 0 0 0 0 0 0 0 0 0 9 9 9 9 0 0 0 0 9 0 0 9 0 0 9 9 9 9 7 0 9
9 0 0 9 0 0 0 0 0 0 0 0 0 0 9 0 0 9 9 9 0 0 9 0 0 0 0 0 0 0 0 9
9 0 0 9 9 9 9 9 9 0 0 9 0 0 0 0 0 9 0 0 0 9 9 9 9 0 0 0 0 0 0 9
9 0 0 0 0 0 0 0 0 0 0 9 0 0 0 0 0 9 0 0 0 0 0 0 0 0 0 9 9 0 0 9
9 0 0 0 0 8 0 0 0 0 9 9 9 9 9 0 0 9 0 0 7 0 0 0 0 0 0 0 0 0 8 9
9 8 0 9 0 0 0 0 0 0 0 0 0 0 0 0 0 9 0 0 0 0 0 8 9 9 0 0 0 0 0 9
9 0 0 9 7 0 0 0 0 0 0 0 0 0 0 0 8 9 0 0 0 0 0 0 0 9 0 0 0 0 0 9
9 0 0 9 9 9 9 9 9 9 9 0 0 9 9 9 9 9 9 9 9 9 0 0 0 9 9 9 9 0 0 9
9 0 0 9 0 0 0 0 0 0 0 0 0 0 0 0 0 0 7 0 0 0 0 0 0 0 0 0 9 0 0 9
9 0 0 0 0 0 0 0 0 0 0 0 0 0 0 0 0 0 0 0 0 0 0 9 0 0 9 9 9 0 0 9
9 0 0 9 9 9 9 0 0 9 9 9 9 9 9 0 0 0 0 0 9 9 9 9 0 0 9 0 0 0 0 9
9 0 0 7 9 0 0 0 0 0 0 0 0 0 0 0 0 9 0 0 9 0 0 9 0 0 9 9 9 0 0 9
9 0 0 0 9 0 0 0 0 0 0 0 0 0 0 0 8 9 0 0 9 0 0 0 0 0 0 0 0 0 0 9
9 0 0 0 0 0 0 9 0 0 9 9 0 0 9 0 0 9 0 0 9 0 0 0 0 0 7 0 0 0 0 9
9 0 0 9 9 0 0 9 0 0 0 9 0 0 9 0 0 9 0 0 0 0 0 0 9 9 9 9 9 0 0 9
9 0 9 9 0 0 9 9 9 9 9 9 0 0 9 9 9 9 9 9 0 0 9 9 9 0 0 9 0 0 0 9
9 0 0 0 0 0 0 8 0 0 0 0 0 0 0 0 0 0 0 0 0 0 0 0 0 0 0 8 0 0 0 9
9 0 0 0 0 0 0 0 0 0 0 0 0 0 0 0 0 0 0 0 0 0 0 0 0 0 0 0 0 0 0 9
9 9 9 9 9 9 9 9 9 9 9 9 9 9 9 9 9 9 9 9 9 9 9 9 9 9 9 9 9 9 9 9